map
    #####
    #   #
    #   #
  ###   ###
  #       #
### # ### #     ######
#   # ### #######    #
#               $   O#
##### #### #@####    #
    #      ###  ######
    ########
map
############
#    #     ###
#    #       #
#    # ####  #
#O $   @ ##  #
#    # #    ##
###### ##    #
  #          #
  #    #     #
  ############
map
        ########
        #      #
        #  #  ##
        #     #
        ##    #
#########   # ###
#      ##       #
##O $   @       #
#      ##########
########
map
              ########
              #      #
   ############      #
   #    #  @ $   O   #
   #    #     #      #
   #          #      #
   #    #     ########
####    #     #
#   # #########
#       ##
#   #    #
#   #   ##
#########
map
        #####
        #   #####
        # # ##  #
        #       #
######### ###   #
#      ##     ###
#O     $      ##
#      ##     @#
#########     ##
        #      #
        ### ## #
          #    #
          ######
end
